11111111111111111
1P00C00X0000000E1
11111111111111111
