1111111
1P01C01
10010E1
1111111
