111111111
1P01000C1
100101101
101101001
1000010E1
111111111
