11111111111111111
1P00C0000000000E1
10111111111111111
1C00P0000000000C1
11111111111111111
