11111111111111111
1P00C000000000001
11111111111111111
