1111111111111111111
1P000000000000000C1
1011111111111111101
10000000000000001
1111111111111111111
10C00000000000000C1
1111111111111111111
1E00000000000000001
1111111111111111111
