11111111111111111
1P0000000000C00E1
10111111111111111
00C000000000000C1
11111111111111111
