11111111111111111
1P0001000C0000001
10000100000000001
11111111111111111
1000000000001E001
1000C000000010001
11111111111111111
