11111111111111111111
1P0000000000000000E1
10111111111111111101
101C1000000000000001
10111111111111111101
100000000000000000C1
11111111111111111111
