11111111111111111111
1P0000000000C0000001
10111111111111111101
10100000010000000001
101000001E1000000001
10111111111000000001
10000000000C00000001
11111111111111111111
