1111111
1P0CEC1
1000001
1000001
1000001
1111111
