1111111111111111111111
11000000001000000010E1
1011101101011101010101
1010000000010001010101
1010111111110111010101
1010001000010101010101
1011111011011101110101
1011111011111111110101
1010001001010100000101
1011101111010111110101
1000101010010000110101
1110101011011111110101
1000101000000000010101
1011101111111010100101
1010101011000001010101
1010101011011111010101
1010101111110101010101
1010100011110101110001
110C101111111111111111
1P01001000000001001001
1111111111111111111111
