111111111111111111111
1P00010000000010000C1
101111101111101011101
100010001000100010001
111010111010111110101
100010000010001000101
101111101110111010111
1C0000100000100010001
101110111011101111101
100010001010000010001
111010101011111010101
1000101010000010101C1
101110101111101010101
1C00000000000C00000E1
111111111111111111111
