1111111
1P001C1
1100111
1E10001
1111111