1111111111111
1P000000000C1
100W00X0i0s01
10000000w0001
1E0C0P0000001
1111111111111