11111111111111111111111
1piy1000000000000000001
1ein1000000000000000001
111110r0i0u00w0i0u00001
10000000000000000000001
100000WWWWWWWWWWWWW0001
10R000000R0000000RW00R1
1RCR000P0R00000CR000RE1
10R000000R0000000RW00R1
1WWWWWWWWWWWWWWWWWW0001
10000W0000W0000000W0001
10000W0c00W0000000W0001
10000W00i0R00o0000W0001
10000W0C00R0000000W0001
1C000W0000W000000CW0001
11111111111111111111111
