111111111111111111111111
1piy1000ein1000000000001
1ein10000001000000000001
111110000001000000000001
1P0000000000000000000001
100000000000000000000001
100w0i0u000W000000000001
100000000000000000000001
100000000000000000000001
10000000000R000000000C01
100000000000000000000001
1000c0i0o000000000000001
100000000000000000000001
100000000000000000000001
100000000000000000000001
10000000000000000000r001
10000000000000000000o001
10000000000000000000u001
10000000000000000000E001
111111111111111111111111