111111111111111111111111
1biy00000000000000000001
1din00000000000000000001
1kowpsrdn000000000000001
1WKWDR000000000000000001
1W0000WWWWWW000000000001
1W000000000W000000000001
1WRWRWR0000W000000000001
1W000000000W000000000001
1WWWWWW000000W0000000001
1D0000W000000W0000000001
1K0000W000000W0000000001
1R0000W000000W0000000001
1C0000W000000W0000000001
1E0000W000000W0000000001
1P0000W000000W0000000001
1W0000W000000W0000000001
1W00000000000W00000000u1
111111111111111111111111