1111111111111111111
1P00000000000000011
10C00000000000001E1
1011111111111111111
101c0i0o00000000001
1011111111111111111
1000000000000000001
1000000000000000001
1000000000000000001
1000000000000000001
1111111111111111111
