1111111111111111111
1P0000000000000cio1
10C0000000000000001
1000000000000000001
1011111111111111111
1000000W00000000001
10w0i0uW00000000001
1000000W00000000001
10C0000W000000000E1
1000000W00000000001
1111111111111111111
